5 5
#####
#_$_#
#___#
#__$#
#####